border_size=1
usage=map

Ww          , Ww          , Wo          , Wo          , Wo          , Wo          , Ww          , Dd          , Dd^Edpp     , Dd^Edpp     , Dd          , Wo          , Ww          , Wo          , Wo          , Uue         , Uue         , Xuce        , Xuce        , Xuce        , Xuce        , Xuce        
Ww          , Ww^Vm       , Wo          , Wo          , Wo          , Wo          , Ww          , Dd          , Dd          , Dd          , Dd^Vda      , Wo          , Ww          , Wo          , Wo          , Uue^Vu      , Uue         , Xuce        , Xuce        , Xuce        , Xuce        , Xuce        
Wo          , Wo          , Xuce        , Xuce        , Ww          , Ww          , Xu          , Ww          , Xu          , Ww          , Ww          , Ww          , Xu          , Ww          , Ww          , Wo          , Ai          , Xuce        , Aa          , Aa          , Aa          , Aa          
Hh          , Hh          , Hh          , Xuce        , Ww          , Xu          , Uue^Vu      , Xu          , Kud         , Xu          , Xu          , Xu          , Uue^Vu      , Xu          , Xu          , Ai          , Aa          , Aa          , 2 Kea       , Aa          , Aa          , Aa          
Mm          , Mm          , Gg          , Ww          , Xu          , Xu          , Uue         , Co          , Co          , Co          , Uue         , Re          , Uue         , Uue         , Xu          , Aa          , Aa          , Cea         , Cea         , Cea         , Rr          , Rr          
Gs^Fp       , Gs^Fp       , Hh          , Ww          , Ww          , Uue         , Re          , Uue         , Co          , Uue         , Re          , Uue         , Uue^Vu      , Uue         , Xu          , Re          , Re          , Aa          , Rr          , Rr          , Aa          , Aa          
Gg          , Gg          , Gs^Fp       , Ww          , Xu          , Uue^Vu      , Xu          , Xu          , Co          , Xu          , Xu          , Xu          , Xu          , Xu          , Gs^Ft       , Md          , Hd          , Re          , Rr          , Re          , Aa^Vha      , Aa          
Gg          , Gg          , Gg          , Ww          , Ww          , Xu          , Xu          , Co          , Qxu         , Co          , Xu          , Ss          , Ss^Vhs      , Mm          , Hd          , Gs^Ft       , Md          , Re          , Rr          , Re          , Re          , Re          
Hh          , Hh          , Gg          , Gg          , Gg          , Wo          , Co          , Co          , Qxu         , Co          , Co          , Ss          , Rb^Uf       , Ss          , Rr          , Rr          , Rr          , Rr          , Re          , Gd          , Gd          , Gd          
Hh          , Hh          , Mm          , Gg          , Gd^Vo       , Wo          , Wo          , Co          , Ww^Bw|      , Co          , Hh          , Ss          , Gg          , Rr          , Re          , Cud         , Hd          , Gs^Ft       , Gs^Ft       , Re          , Re          , Re          
Gg          , Gg          , Gg          , Gg          , Gg          , Gg          , Gg          , Ww          , Gg          , Ww          , Wwf         , Gs^Fp       , Rr          , Rr          , Gs          , Re          , Gs^Ft       , Md          , Re          , Re          , Gd          , Gd          
Gg          , Gg          , Gs          , Gs          , Mm          , Gs^Fp       , Gg          , Gg          , Rr          , Rr          , Gs^Fp       , Wwf         , Ww          , Gs          , Ww          , Gs          , Gs          , Re          , Re          , Gd          , Re          , Re          
Gg          , Gg          , Gs          , Gs^Fp       , Gs^Fp       , Hh          , Chr         , Gg          , Rr          , Gg          , Ss          , Hh          , Cud         , Ww^Bw|      , Cud         , Wo          , Wo          , Gd^Vo       , Re          , Md          , Hd          , Hd          
Gg          , Gg          , Gg          , Gg          , Rr          , Rr          , Rr          , Rr          , Ss          , Rb^Uf       , Ss          , Cud         , Cud         , Ql          , Cud         , Cud         , Wo          , Gs          , Gd          , Re          , Hd          , Hd          
Gs          , Gs          , Gs          , Rr          , Gg          , Mm          , Gs^Fp       , Hh          , Mm          , Ss^Vhs      , Ss          , Xu          , Cud         , Ql          , Cud         , Xu          , Xu          , Ww          , Ww          , Gs          , Gd          , Gd          
Aa          , Aa^Vha      , Rr          , Rr          , Gs          , Hh          , Mm          , Gs^Fp       , Xu          , Xu          , Xu          , Xu          , Xu          , Cud         , Xu          , Xu          , Uu^Vu       , Xu          , Ww          , Re          , Re          , Re          
Aa          , Aa          , Rr          , Aa          , Aa          , Gs          , Gs          , Xu          , Uu          , Uu^Vu       , Uu          , Urb         , Uu          , Cud         , Uu          , Urb         , Uu          , Ww          , Ww          , Hd          , Gs^Ft       , Gs^Ft       
Rr          , Rr          , Cea         , Cea         , Cea         , Aa          , Aa          , Xu          , Uu          , Uu          , Urb         , Uu          , Cud         , Cud         , Cud         , Uu          , Xu          , Xu          , Ww          , Re          , Md          , Md          
Aa          , Aa          , Aa          , 1 Kea       , Aa          , Aa          , Ai          , Xu          , Xu          , Uu^Vu       , Xu          , Xu          , Xu          , Kud         , Xu          , Uu^Vu       , Xu          , Ww          , Xu          , Hd          , Hd          , Hd          
Aa          , Aa          , Aa          , Aa          , Xu          , Ai          , Wo          , Ww          , Ww          , Xu          , Ww          , Ww          , Ww          , Xu          , Ww          , Xu          , Ww          , Ww          , Xu          , Xu          , Wo          , Wo          
Xu          , Xu          , Xu          , Xu          , Xu          , Uu          , Uu^Vu       , Wo          , Wo          , Ww          , Wo          , Dd^Vdt      , Dd          , Dd          , Dd          , Ww          , Wo          , Wo          , Wo          , Wo          , Ww^Vm       , Ww          
Xu          , Xu          , Xu          , Xu          , Xu          , Uu          , Uu          , Wo          , Wo          , Ww          , Wo          , Dd          , Dd          , Dd          , Dd          , Ww          , Wo          , Wo          , Wo          , Wo          , Ww          , Ww          
