border_size=1
usage=map

_s          , _s          , _s          , _s          , _s          , _s          , _s          , _s          , _s          , _s          , _s          , _s          , _s          , _s          , _s          , _s          , _s          , _s          , _s          , _s          , _s          , _s          , _s          , _s          , _s          , _s          , _s          , _s          , _s          , _s          , _s          
_s          , _s          , _s          , _s          , _s          , _s          , _s          , _s          , _s          , _s          , _s          , _s          , _s          , _s          , _s          , _s          , Rr          , _s          , Ww^Vm       , _s          , _s          , _s          , _s          , _s          , _s          , _s          , _s          , _s          , _s          , _s          , _s          
_s          , _s          , _s          , _s          , _s          , _s          , _s          , _s          , _s          , _s          , _s          , _s          , _s          , _s          , Rr          , Rr          , Rr          , Rr          , Wo          , Wo          , Wo          , _s          , _s          , _s          , _s          , _s          , _s          , _s          , _s          , _s          , _s          
_s          , _s          , _s          , _s          , _s          , _s          , _s          , _s          , Uu^Vu       , _s          , _s          , _s          , _s          , Wwf         , Ss          , Ss^Vhs      , Ql          , Wo          , Ww^Vm       , Wo          , Wo          , Uu^Vu       , _s          , _s          , _s          , _s          , _s          , _s          , _s          , _s          , _s          
_s          , _s          , _s          , _s          , Ss^Vhs      , Ss          , Wwf         , 4 Kud       , Cud         , Uu          , Uu          , _s          , _s          , Wwf         , Ss          , Ql          , Ql          , Wwt         , Wwt         , Wwt         , Wo          , Uu          , _s          , _s          , _s          , _s          , _s          , _s          , _s          , _s          , _s          
_s          , _s          , _s          , _s          , Ss          , Ww          , Ww          , Cud         , Cud         , Cud         , Uu          , _s          , _s          , Wwf         , Ss          , Wwt         , Wwt         , Wwt         , Wwt         , Wwt         , Ce          , Ce          , _s          , _s          , _s          , _s          , _s          , _s          , _s          , _s          , _s          
_s          , _s          , _s          , Ss          , Ww          , Ww          , Ww          , Ww^Vm       , Wo          , Uu          , Cud         , _s          , _s          , Wwf         , Md          , Wwt         , Md          , Wwt         , Dd^Vdt      , Md          , Ce          , 2 Ke        , Uu          , _s          , _s          , _s          , _s          , _s          , _s          , _s          , _s          
_s          , _s          , Ss          , Ss^Vhs      , Ww          , Ww          , Ww          , Ww          , Wo          , Wo          , Wwf         , _s          , _s          , Wwf         , Md          , Dd^Do       , Hd          , Dd^Do       , Dd^Vdt      , Md          , Rr          , Ce          , _s          , _s          , _s          , _s          , _s          , _s          , _s          , _s          , _s          
_s          , _s          , Ss          , Ww          , Ww          , Ww          , Ww          , Ww^Vm       , Wo          , Wo          , Wwf         , _s          , _s          , _s          , Ce          , Hd          , Dd^Vda      , Hd          , Ds          , Rr          , Uu          , Uu          , _s          , _s          , _s          , _s          , _s          , _s          , _s          , _s          , _s          
_s          , _s          , Ss^Vhs      , Ww          , Ww          , Ww          , Ww          , Ww          , Wo          , Wo          , Wwf         , Wwt         , Ww^Vm       , Uu          , Uu          , Md          , Md          , Dd^Vdt      , Wwr         , Wwr         , Wwt         , Wwt         , Wwt         , Wo          , Wo          , _s          , _s          , _s          , _s          , _s          , _s          
_s          , _s          , Ss          , Ww          , Ww          , Ww          , Ww          , Ww^Vm       , Wo          , Wwf         , Wwt         , Wwt         , Wwt         , Wwt         , Wwt         , Uu          , Wwt         , Wwr         , Wwt         , Wwt         , Ww^Vm       , Wwt         , Wwt         , Ww^Vm       , Wo          , _s          , _s          , _s          , _s          , _s          , _s          
_s          , _s          , Ss          , Ww          , Ww          , Ww          , Wo          , Wo          , Wwf         , Wwf         , Wwt         , Wwt         , Wwt         , Wwt         , Wwt         , Ww^Vm       , Wwt         , Wwt         , Wwt         , Wwt         , Wwt         , Wwt         , Wwt         , Wo          , Wo          , Wo          , _s          , _s          , _s          , _s          , _s          
_s          , _s          , Ss^Vhs      , Ww          , Wo          , Wo          , Wwf         , Wwf         , Mm^Vhh      , Rr          , Rr          , Ww^Vm       , Wwr         , Wwt         , Wwt         , Wwt         , Wwt         , Wwt         , Ai          , Wwr         , Wwr         , Wwt         , Wwt         , Wo          , Wo          , Wo          , _s          , _s          , _s          , _s          , _s          
_s          , _s          , _s          , Wo          , _s          , Wwf         , Rr          , Rr          , Rr          , Rr          , Rr          , Wwr         , Ai          , Wwr         , Wwt         , Wwt         , Ai          , Ai          , Ai          , Chw         , Wwr         , Wwt         , Wwt         , Ww^Vm       , Rr          , Wo          , _s          , _s          , _s          , _s          , _s          
_s          , _s          , _s          , _s          , _s          , _s          , _s          , _s          , _s          , _s          , _s          , Wwf         , Ai          , Chw         , Ss          , Wwt         , Ai          , Ai          , Ai          , Chr         , Wwf         , Wwt         , Rd          , Rr          , Rr          , _s          , _s          , _s          , _s          , _s          , _s          
_s          , _s          , _s          , _s          , _s          , _s          , _s          , _s          , _s          , _s          , _s          , Wwf         , Wwf         , Rr          , Ss          , Rr          , Rr          , Ai          , Chr         , Chr         , Kh          , Wwf         , Rd          , Rr          , Ww          , Wo          , _s          , _s          , _s          , _s          , _s          
_s          , _s          , _s          , _s          , _s          , _s          , _s          , _s          , _s          , _s          , _s          , _s          , Wwf         , Ss          , Rr          , Ss^Vhs      , Ss          , Rr          , Rr          , Wwf         , Wwt         , Xu          , Wwf         , Ss^Vhs      , Ww          , Wo          , Wo          , _s          , _s          , _s          , _s          
_s          , _s          , _s          , _s          , _s          , _s          , _s          , _s          , _s          , _s          , _s          , _s          , Rr          , Rr          , Ss          , Rr          , Rr          , Ss^Vhs      , Ss          , Wwt         , Xu          , Xu          , Wwf         , Ss          , Ww          , Ww^Vm       , Wo          , _s          , _s          , _s          , _s          
_s          , _s          , _s          , _s          , _s          , _s          , _s          , _s          , _s          , _s          , _s          , _s          , Wwf         , Ss          , Ss          , Ss          , Wwt         , Ss          , Wo          , Xu          , Xu          , Xu          , Wwf         , Ss          , Ww          , Ww          , Wo          , Wo          , _s          , _s          , _s          
_s          , _s          , _s          , _s          , _s          , _s          , _s          , _s          , _s          , _s          , _s          , Wwf         , Wwt         , Wwt         , Wwt         , Wwt         , Wwt         , Wwt         , Wo          , Xu          , Xu          , Wwf         , Ss          , Ss^Vhs      , Ww          , Ww^Vm       , Wo          , Wo          , Wo          , _s          , _s          
_s          , _s          , _s          , _s          , _s          , _s          , _s          , _s          , _s          , _s          , _s          , Wwf         , Wwt         , Ww^Vm       , Wwt         , Ww^Vm       , Wwt         , Wwt         , Wo          , Wo          , Xu          , Wwf         , Ss          , Ww          , Ww          , Ww          , Wo          , Wo          , Wo          , _s          , _s          
_s          , _s          , _s          , _s          , _s          , _s          , _s          , _s          , _s          , _s          , Rd          , Wwf         , Wwt         , Wwt         , Wwt         , Wwt         , Wwf         , Wwf         , Ch          , Wo          , Xu          , Wwf         , Aa          , Ww          , Ww          , Ww^Vm       , Wo          , Wo          , Wo          , _s          , _s          
_s          , _s          , _s          , _s          , _s          , _s          , _s          , _s          , _s          , _s          , Rd          , Rr          , Rr          , Wwt         , Wo          , Wwt         , Rr          , Ch          , Ch          , Ch          , Xu          , Aa          , Aa          , Aa          , Ai          , Ww          , Wo          , Wo          , Wo          , _s          , _s          
_s          , _s          , _s          , _s          , _s          , _s          , _s          , _s          , _s          , _s          , Rr          , Rd          , Ch          , Rr          , Uu          , Rd          , Rr          , Rd          , 3 Kh        , Uu          , Aa          , Aa          , Aa          , Aa          , Aa          , Ai          , Ai          , Wo          , Wo          , _s          , _s          
_s          , _s          , _s          , _s          , _s          , _s          , _s          , _s          , _s          , _s          , Rd          , Ch          , Ch          , Ch          , Uu          , Rd          , Rd          , Rr          , Rr          , Uu          , Aa          , Aa          , Ai          , Aa          , Aa          , Ai          , Ai          , Ai          , Ai          , _s          , _s          
_s          , _s          , _s          , _s          , _s          , _s          , _s          , _s          , _s          , _s          , Rr          , Rd          , 1 Kh        , Rr          , Uu          , Xu          , Rr          , Rd          , Rr          , Uu          , Uu          , Ai          , Ai          , Ai          , Ai          , Ai          , Ai          , Ai          , _s          , _s          , _s          
_s          , _s          , _s          , _s          , _s          , _s          , _s          , _s          , _s          , _s          , Rd          , Rr          , Rr          , Rr          , Uu          , Xu          , Rd          , Rr          , Ww          , Rr          , Ww          , Ai          , Ai          , Ai          , Ai          , Ai          , Ai          , Ai          , _s          , _s          , _s          
_s          , _s          , _s          , _s          , _s          , _s          , _s          , _s          , Wwf         , Wwf         , Ww          , Rd          , Rr          , Rr          , Uu          , Xu          , Xu          , Rd          , Ww          , Ww          , Ww          , Ww          , _s          , _s          , _s          , _s          , _s          , _s          , _s          , _s          , _s          
_s          , _s          , _s          , _s          , _s          , _s          , _s          , _s          , Wwf         , Ww          , Ww          , Wo          , Wo          , Rr          , Wo          , Xu          , Xu          , Wwf         , Ww          , Ww^Vm       , Wo          , Wo          , Wo          , _s          , _s          , _s          , _s          , _s          , _s          , _s          , _s          
_s          , _s          , _s          , _s          , _s          , _s          , _s          , Wwf         , Ss^Vhs      , Ww          , Ww^Vm       , Wo          , Wo          , Wo          , Wo          , Wo          , Wwf         , Ss^Vhs      , Ww          , Ww          , Ww^Vm       , Wo          , Wo          , Wo          , Wo          , _s          , _s          , _s          , _s          , _s          , _s          
_s          , _s          , _s          , _s          , _s          , _s          , _s          , Wwf         , Ss          , Ww          , Ww          , Wo          , Wo          , Wo          , Wo          , Wo          , Wwf         , Ss          , Ww          , Ww          , Ww          , Wo          , Wo          , Wo          , Wo          , _s          , _s          , _s          , _s          , _s          , _s          
_s          , _s          , _s          , _s          , _s          , _s          , Wwf         , Wwf         , Ss          , Ww          , Ww^Vm       , Wo          , Wo          , Wo          , Wo          , Wo          , Wwf         , Ss          , Ss          , Ww          , Ww          , Ww^Vm       , Wo          , Wo          , Wo          , Wo          , _s          , _s          , _s          , _s          , _s          
_s          , _s          , _s          , _s          , _s          , _s          , Wwf         , Ss^Vhs      , Ww          , Ww          , Ww          , Wo          , Wo          , Wo          , Wo          , Wo          , Wwf         , Ss^Vhs      , Ss          , Ww          , Ww          , Ww          , Ww^Vm       , Wo          , Wo          , Wo          , Wo          , _s          , _s          , _s          , _s          
_s          , _s          , _s          , _s          , _s          , _s          , Wwf         , Ss          , Ww          , Ww          , Ww^Vm       , Wo          , Wo          , Wo          , Wo          , Wo          , Wwf         , Ss          , Ss          , Ss          , Ww          , Ww          , Ww          , Wo          , Wo          , Wo          , Wo          , _s          , _s          , _s          , _s          
_s          , _s          , _s          , _s          , _s          , Wwf         , Ss^Vhs      , Ss          , Ww          , Ww          , Ww          , Wo          , Wo          , Wo          , Wo          , Wo          , Wwf         , Ss          , Ss          , Ss          , Ww          , Ww          , Ww          , Wo          , Wo          , Wo          , Wo          , Wo          , _s          , _s          , _s          
_s          , _s          , _s          , _s          , _s          , Wwf         , Ss          , Ww          , Ww          , Ww          , Ww^Vm       , Wo          , Wo          , Wo          , Wo          , Wo          , Wwf         , Ss^Vhs      , Ss          , Ss          , Ww          , Ww          , Ww          , Wo          , Wo          , Wo          , Wo          , Wo          , _s          , _s          , _s          
_s          , _s          , _s          , _s          , _s          , Wwf         , Ss          , Ww          , Ww          , Ww          , Ww          , Wo          , Wo          , Wo          , Wo          , Wo          , Wwf         , Ss          , Ss          , Ss          , Ww          , Ww          , Ww          , Wo          , Wo          , Wo          , Wo          , Wo          , _s          , _s          , _s          
_s          , _s          , _s          , _s          , _s          , Wwf         , Ss          , Ww          , Ww          , Ww          , Ww          , Wo          , Wo          , Wo          , Wo          , Wo          , Wwf         , Ss          , Ss          , Ss          , Ww          , Ww          , Ww          , Wo          , Wo          , Wo          , Wo          , Wo          , _s          , _s          , _s          
