border_size=1
usage=map

_off^_usr   , _off^_usr   , _off^_usr   , _off^_usr   , _off^_usr   , _off^_usr   , _off^_usr   , _off^_usr   , _off^_usr   , _off^_usr   , _off^_usr   , _off^_usr   , _off^_usr   , _off^_usr   , _off^_usr   , _off^_usr   , _off^_usr   , _off^_usr   , _off^_usr   , _off^_usr   , _off^_usr   , _off^_usr   , _off^_usr   
_off^_usr   , _off^_usr   , _off^_usr   , _off^_usr   , _off^_usr   , _off^_usr   , _off^_usr   , _off^_usr   , _off^_usr   , _off^_usr   , _off^_usr   , _off^_usr   , _off^_usr   , _off^_usr   , _off^_usr   , _off^_usr   , _off^_usr   , _off^_usr   , _off^_usr   , _off^_usr   , _off^_usr   , _off^_usr   , _off^_usr   
_off^_usr   , _off^_usr   , _off^_usr   , _off^_usr   , _off^_usr   , _off^_usr   , _off^_usr   , _off^_usr   , _off^_usr   , _off^_usr   , Ch          , Mm          , Ch          , _off^_usr   , _off^_usr   , _off^_usr   , _off^_usr   , _off^_usr   , _off^_usr   , _off^_usr   , _off^_usr   , _off^_usr   , _off^_usr   
_off^_usr   , _off^_usr   , _off^_usr   , _off^_usr   , _off^_usr   , _off^_usr   , _off^_usr   , _off^_usr   , Gg          , Hh          , Ch          , 1 Kh        , Ch          , Hh          , Ss          , _off^_usr   , _off^_usr   , _off^_usr   , _off^_usr   , _off^_usr   , _off^_usr   , _off^_usr   , _off^_usr   
_off^_usr   , _off^_usr   , _off^_usr   , _off^_usr   , _off^_usr   , _off^_usr   , Gg          , Gg          , Ww          , Gg          , Gg          , Re          , Re          , Gs^Fp       , Gg          , Gs^Fms      , Xu          , _off^_usr   , _off^_usr   , _off^_usr   , _off^_usr   , _off^_usr   , _off^_usr   
_off^_usr   , _off^_usr   , _off^_usr   , _off^_usr   , Re          , Re          , Ss          , Ww^Bw\      , Ww^Bw\      , Ww          , Gg          , Gg          , Hh          , Re          , Xu          , Xu          , Uu          , Uu          , Uh          , _off^_usr   , _off^_usr   , _off^_usr   , _off^_usr   
_off^_usr   , _off^_usr   , Dd^Do       , Re          , Ur          , Ss^Vhs      , Ww          , Ww          , Wwf         , Gg^Ve       , Gg          , Gg          , Gg          , Re          , Xu          , Uu          , Uh          , Ur          , Ch          , Ch          , Mm          , _off^_usr   , _off^_usr   
_off^_usr   , _off^_usr   , Re          , Ds          , Uu^Uf       , Xu          , Wwf         , Ww          , Wwf         , Wwf         , Gg          , Gs^Fp       , Gg          , Re          , Ur          , Ur          , Gg          , Re          , Re          , 4 Kh        , Ch          , _off^_usr   , _off^_usr   
_off^_usr   , _off^_usr   , Re          , Ur          , Xu          , Xu          , Mm          , Wwf         , Rr          , Gg          , Ss^Vhs      , Ggf         , Re^Uf       , Re          , Gg          , Gg          , Gs^Fms      , Gg          , Re          , Ch          , Hh          , _off^_usr   , _off^_usr   
_off^_usr   , _off^_usr   , Re          , Uu^Vu       , Gs^Fp       , Rr          , Rr          , Rr          , Chw         , Gg          , Re          , Gs^Fds      , Mm          , Re          , Re          , Gg          , Ww          , Ggf         , Gg          , Re          , Re          , _off^_usr   , _off^_usr   
_off^_usr   , _off^_usr   , Re          , Hh          , Gg          , Gg          , Hh          , Gg          , Gg          , Gg^Fet      , Hh          , Hh          , Gs^Fds      , Hh          , Ss^Vhs      , Gg          , Wwf         , Ww          , Gg          , Gg^Ve       , Re          , _off^_usr   , _off^_usr   
_off^_usr   , _off^_usr   , Re          , Gg          , Gg          , Gg          , Wwf         , Gg          , Ss^Vhs      , Re          , Gs^Fds      , Gg^Ve       , Hh          , Re          , Gg          , Gg          , Hh          , Gg          , Gg          , Gg          , Re          , _off^_usr   , _off^_usr   
_off^_usr   , _off^_usr   , Re          , Gg^Ve       , Gg          , Ww          , Ww          , Gg          , Re          , Hh          , Mm          , Hh          , Re          , Gg^Fet      , Chw         , Gg          , Rr          , Gg          , Gs^Fp       , Hh          , Re          , _off^_usr   , _off^_usr   
_off^_usr   , _off^_usr   , Hh          , Re          , Re          , Ggf         , Gs^Fms      , Gg          , Gg          , Re          , Re^Uf       , Gs^Fds      , Ss^Vhs      , Gg          , Rr          , Rr          , Mm          , Rr          , Xu          , Uu^Vu       , Re          , _off^_usr   , _off^_usr   
_off^_usr   , _off^_usr   , Ch          , Ch          , Re          , Gg          , Gg          , Gg          , Ur          , Re          , Gg          , Ggf         , Gg          , Gg          , Wwf         , Wwf         , Wwf         , Xu          , Uu^Uf       , Ur          , Re          , _off^_usr   , _off^_usr   
_off^_usr   , _off^_usr   , Mm          , 3 Kh        , Ch          , Re          , Uh          , Ur          , Xu          , Re          , Gg          , Gs^Fp       , Gg          , Wwf         , Wwf         , Ww          , Ww          , Xu          , Ur          , Ds          , Dd^Do       , _off^_usr   , _off^_usr   
_off^_usr   , _off^_usr   , _off^_usr   , Ch          , Uh          , Ur          , Uu          , Uu          , Xu          , Re          , Hh          , Gg          , Gg          , Gg^Ve       , Ww^Bw\      , Ww          , Ss          , Ss^Vhs      , Re          , Re          , _off^_usr   , _off^_usr   , _off^_usr   
_off^_usr   , _off^_usr   , _off^_usr   , _off^_usr   , _off^_usr   , Uu          , Xu          , Xu          , Gg          , Re          , Re          , Gg          , Gg          , Ww          , Ww          , Ww^Bw\      , Gg          , Re          , _off^_usr   , _off^_usr   , _off^_usr   , _off^_usr   , _off^_usr   
_off^_usr   , _off^_usr   , _off^_usr   , _off^_usr   , _off^_usr   , _off^_usr   , _off^_usr   , Gs^Fms      , Ss          , Gs^Fp       , Ch          , Re          , Ch          , Gg          , Gg          , Gg          , _off^_usr   , _off^_usr   , _off^_usr   , _off^_usr   , _off^_usr   , _off^_usr   , _off^_usr   
_off^_usr   , _off^_usr   , _off^_usr   , _off^_usr   , _off^_usr   , _off^_usr   , _off^_usr   , _off^_usr   , _off^_usr   , Hh          , Ch          , 2 Kh        , Ch          , Hh          , _off^_usr   , _off^_usr   , _off^_usr   , _off^_usr   , _off^_usr   , _off^_usr   , _off^_usr   , _off^_usr   , _off^_usr   
_off^_usr   , _off^_usr   , _off^_usr   , _off^_usr   , _off^_usr   , _off^_usr   , _off^_usr   , _off^_usr   , _off^_usr   , _off^_usr   , _off^_usr   , Mm          , _off^_usr   , _off^_usr   , _off^_usr   , _off^_usr   , _off^_usr   , _off^_usr   , _off^_usr   , _off^_usr   , _off^_usr   , _off^_usr   , _off^_usr   
_off^_usr   , _off^_usr   , _off^_usr   , _off^_usr   , _off^_usr   , _off^_usr   , _off^_usr   , _off^_usr   , _off^_usr   , _off^_usr   , _off^_usr   , _off^_usr   , _off^_usr   , _off^_usr   , _off^_usr   , _off^_usr   , _off^_usr   , _off^_usr   , _off^_usr   , _off^_usr   , _off^_usr   , _off^_usr   , _off^_usr   
_off^_usr   , _off^_usr   , _off^_usr   , _off^_usr   , _off^_usr   , _off^_usr   , _off^_usr   , _off^_usr   , _off^_usr   , _off^_usr   , _off^_usr   , _off^_usr   , _off^_usr   , _off^_usr   , _off^_usr   , _off^_usr   , _off^_usr   , _off^_usr   , _off^_usr   , _off^_usr   , _off^_usr   , _off^_usr   , _off^_usr   
