border_size=1
usage=map

Mm^Xm       , Mm^Xm       , Mm^Xm       , Mm^Xm       , Aa^Fpa      , Aa^Fda      , Aa^Fda      , Re          , Re          , Re          , Re          , Re          , Wwf         , Re          , Re          , Re          , Re          , Re          , Re          , Dd          , Dd^Dc       , Md^Xm       , Md^Xm       , Md^Xm       
Mm^Xm       , Mm^Xm       , Ms          , Ms          , Aa^Fpa      , Aa^Fda      , Re          , Re          , Re          , Re          , Mm          , Ss^Vhs      , 3 Khw       , Ch          , Re          , Re          , Re          , Re          , Dd          , Dd          , Dd^Vda      , Dd          , Md^Xm       , Md^Xm       
Mm^Xm       , Mm^Xm       , Ms          , Aa^Fpa      , Re^Gvs      , Re^Gvs      , Re^Gvs      , Re          , Rp          , Rp          , Ch          , Chw         , Chr         , Gg          , Re          , Re          , Ww          , Re          , Re          , Hd          , Hd          , Dd^Do       , Dd          , Md          
Ai          , Ms^Vhha     , Aa^Fpa      , Re          , Re^Gvs      , Re^Gvs      , Re^Gvs      , Re          , Rp          , Re          , Gs^Fds      , Wwf         , Gg          , Re          , Gg^Wm       , Ww          , Wo          , Wo          , Wo          , Re          , Re          , Hd          , Re          , Dd          
Ai          , Ai          , Aa^Fpa      , Re          , Re^Gvs      , Re^Gvs      , Gs^Fms      , Re          , Rp          , Uu^Uf       , Gs^Fdw      , Wwf         , Wwf         , Gg          , Gg^Ve       , Ww          , Wo          , Wo          , Wo          , Ss^Vm       , Ss          , Re          , Re          , Re          
Ha^Fda      , Ha^Fda      , Re          , Re          , Rp          , Gs          , Rp          , Rp          , Gs          , Gg          , Gs^Fp       , Gs^Fdw      , Wwf         , Gg          , Gg          , Ww          , Wo          , Wo          , Ss          , Khs         , Chs         , Re          , Re          , Re          
Re          , Re          , Re          , Ch          , Gg          , Rp          , Gs          , Gs          , Gg          , Gs          , Gg          , Gs^Vht      , Wwf         , Gg          , Hh^Vhh      , Ww          , Mm          , Gs          , Re          , Re          , Re          , Re          , Gs^Fdw      , Gs^Fdw      
Gs^Fdw      , Re          , Gs^Fdw      , Ch          , Gs^Fp       , Gs^Fp       , Gs^Fdw      , Gs          , Gs^Vht      , Gg          , Mm          , Wwf         , Ggf         , Chr         , 1 Khr       , Rp          , Rp          , Re          , Re          , Re          , Re          , Gs^Fdw      , Wwf         , Gs^Fdw      
Wwf         , Gs^Fdw      , Chr         , Khr         , Wwf^Bw\     , Wwf         , Wwf         , Gs^Fdw      , Ss          , Ggf         , Wwr         , Wwr         , Mm          , Gs^Fmw      , Wwf         , Ss          , Wwf         , Rp          , Wwf^Bw\     , Wwf         , Chw         , Wwf         , Gs^Fdw      , Wwf         
Gs^Fdw      , Wwf         , Chw         , Wwf         , Re          , Rp          , Rp          , Wwf         , Ss          , Wwf         , Gs^Fms      , Wo          , Wwr         , Wwf         , Gg          , Ss          , Gs^Fdw      , Wwf         , Gg^Fet      , Khr         , Ch          , Gs^Fdw      , Gs^Fdw      , Gs^Fdw      
Gs^Fdw      , Gs^Fdw      , Re          , Re          , Re          , Re          , Gs          , Rp          , 2 Khr       , Wwf         , Wwf         , Wwr         , Hh          , Ggf         , Gg          , Gs^Vht      , Gg          , Gs^Fdw      , Gs          , Gg^Fet      , Ch          , Ch          , Re          , Gs^Fdw      
Gs^Fdw      , Gs^Fdw      , Re          , Re          , Gs          , Gs          , Mm          , Gs^Fmw      , Hh^Vhh      , Chr         , Gg          , Wwf         , Gs^Vht      , Gg          , Gs          , Gg          , Gs          , Gg          , Rp          , Rp          , Re          , Re          , Aa^Fda      , Re          
Re          , Re          , Chs         , Gs          , Ss          , Wo          , Wo          , Ww          , Gg          , Ggf         , Gg          , Wwf         , Gs^Fdw      , Gg          , Gs          , Gg          , Rp          , Rp          , Re          , Re          , Re          , Re          , Aa^Fpa      , Ha^Fda      
Re          , Re          , Ss          , Khs         , Wo          , Wo          , Wo          , Ww          , Gg^Ve       , Gg          , Gg          , Wwf         , Gs^Fp       , Gs^Fdw      , Uu^Uf       , Gs          , Rp          , Re          , Re          , Re          , Re          , Aa^Fpa      , Aa^Vha      , Ha^Fda      
Dd          , Re          , Re          , Ss^Vm       , Gg          , Wo          , Ww          , Ww          , Ggf         , Gg          , Wwf         , Wwf         , Gg          , Gg^Fet      , Gs          , Gs          , Rp          , Gs^Fms      , Re^Gvs      , Re          , Gg^Wm       , Aa^Fda      , Aa^Fpa      , Ha^Fda      
Hd          , Hd          , Hd          , Re          , Re          , Gg^Wm       , Gg          , Ww          , Gg          , Gg          , Wwf         , Gg          , 4 Khr       , Ch          , Rp          , Rp          , Re          , Re^Gvs      , Re^Gvs      , Re^Gvs      , Re^Gvs      , Aa^Fda      , Ai          , Ai          
Md          , Dd^Do       , Dd^Vda      , Hd          , Dd^Dc       , Re          , Re          , Gg          , Gg          , Gg          , Ch          , Chw         , Mm          , Re          , Re          , Re          , Re          , Re^Gvs      , Re^Gvs      , Re^Gvs      , Aa^Fpa      , Aa^Fpa      , Ms          , Ai          
Md^Xm       , Dd          , Dd          , Hd          , Re          , Re          , Re          , Re          , Re          , Ch          , Re          , Ss^Vhs      , Re          , Re          , Re          , Re          , Re          , Re^Gvs      , Aa^Fpa      , Aa^Fpa      , Ms          , Ms          , Md^Xm       , Mm^Xm       
Md^Xm       , Md^Xm       , Dd          , Re          , Re          , Re          , Re          , Re          , Re          , Re          , Re          , Wwf         , Re          , Re          , Re          , Re          , Re          , Aa^Fpa      , Ms          , Mm          , Mm^Xm       , Mm^Xm       , Mm^Xm       , Mm^Xm       
